QQQ|INVSC QQQ TRUST SRS 1 ETF
SPY|SPDR S&P 500 ETF
IWM|ISHARES RUSSELL 2000 ETF
DIA|SPDR DOW JONES INDUSTRIAL AVRG ETF
RSP|INVSC S P 500 EQUAL WEIGHT ETF IV
BTC-USD|Bitcoin Futures
RTY=F|E-mini Russell 2000 Index Futures
YM=F|Mini Dow Jones Industrial Average Futures,ETH
GC=F|Gold Futures, ETH
NQ=F|E-mini Nasdaq 100 Index Futures,ETH
ES|E-mini S&P 500 Futures,ETH
XLK|TECHNOLOGY SELECT SECTOR SPDR ETF IV
SMH|VANECK SEMICONDUCTOR ETF
XLF|SELECT STR FINANCIAL SELECT SPDR ETF
XLV|SELECT SECTOR HEALTH CARE SPDR ETF
XLE|ENERGY SELECT SECTOR SPDR ETF
XLC|COMMUNICAT SVS SLCT SEC SPDR ETF
IYR|ISHARES US REAL ESTATE ETF IV
ARKK|ARK INNOVATION ETF
XLU|SELECT SECTOR UTI SELECT SPDR ETF
XLB|SPDR FUND MATERIALS SELECT SECTR ETF
IYT|ISHARES US TRANSPORTATION ETF
XLI|SELECT SECTOR INDUSTRIAL SPDR ETF
IBB|iShares Nasdaq Biotechnology Index Fund
GBTC|GRAYSCALE BITCOIN TR BTC
AMZN|Amazon.com Inc
PLTR|PALANTIR TECHNOLOGIE A
NFLX|NETFLIX INC
META|META PLATFORMS INC A
TSLA|TESLA INC
WMT|WALMART INC
CRM|Salesforce Inc
ORCL|ORACLE CORP
AAPL|APPLE INC
C|Citigroup Inc
MSFT|Microsoft Corp
PTON|PELOTON INTERACTIVE
JPM|JPMORGAN CHASE & CO
UAL|United Airlines Hldg
GOOG|ALPHABET INC C
LMND|LEMONADE INC
NVDA|NVIDIA CORP
WFC|WELLS FARGO & CO
OKTA|OKTA INC A
SMCI|SUPER MICRO COMPUTER
AMD|Advanced Micro Devic
INTC|INTEL CORP
ABBV|ABBVIE INC
BABA|ALIBABA GROUP HLDG L ADR
GOOGL|ALPHABET INC A
AVGO|BROADCOM INC
BA|BOEING CO
BKNG|BOOKING HLDGS INC
SQ|Block Inc A
CAT|CATERPILLAR INC
CVX|CHEVRON CORP NEW
CMG|CHIPOTLE MEXICAN GRI
NET|CLOUDFLARE INC A
CRSP|CRISPR THERAPEUTICS
DDOG|DATADOG INC A
DE|DEERE & CO
TSM|TAIWAN SEMICONDUCTOR ADR
DUK|DUKE ENERGY CORP NEW
LLY|ELi Lilly and Co
EOG|EOG RES INC
XOM|EXXON MOBIL CORP
FSLR|FIRST SOLAR INC
GE|GE Aerospace
GTLB|GITLAB INC A
GS|GOLDMAN SACHS GROUP
SOFI|SOFI TECHNOLOGIES IN
HD|HOME DEPOT INC
IBM|IBM CORP
RIVN|RIVIAN AUTOMOTIVE IN A
RTX|RTX CORP
RBRK|RUBRIK INC A
AI|C3 AI INC A
MU|MICRON TECHNOLOGY IN
MRK|Merck & Co. Inc.
NEE|NEXTERA ENERGY INC
NKE|NIKE INC B
OUST|OUSTER INC A
PEP|PEPSICO INC
PSNL|PERSONALIS INC
PG|PROCTER & GAMBLE CO
QCOM|QUALCOMM INC
ROKU|ROKU INC A
SHOP|SHOPIFY INC A
SO|SOUTHERN CO
SBUX|STARBUCKS CORP
SU|SUNCOR ENERGY INC NE
TGT|TARGET CORP
TJX|TJX COS INC NEW
KO|The Coca-Cola Co
UNP|UNION PAC CORP
UPS|UNITED PARCEL SVC IN B
UNH|UNITEDHEALTH GROUP I
VLO|VALERO ENERGY CORP N
COST|COSTCO WHSL CORP NEW
Z|ZILLOW GROUP INC Z
ZM|ZOOM COMMUNICATIONS A
AMAT|APPLIED MATLS INC
ASTS|AST SPACEMOBILE INC A
BAC|BANK OF AMERICA CORP
BIDU|BAIDU INC A ADR
DOCU|DOCUSIGN INC
JNJ|JOHNSON & JOHNSON
LMT|LOCKHEED MARTIN CORP
LOW|LOWES COS INC
LRCX|LAM RESH CORP Equity
LULU|LULULEMON ATHLETICA
MCD|MCDONALDS CORP
MP|MP MATLS CORP A
SLV|ISHARES SILVER TRUST ETF IV
TCTZF|Tencent Holdings Limited
MA|Mastercard Incorporated
NVO|Novo Nordisk A/S